Andorra - AD - Andorra la Vieja
Emiratos Árabes Unidos - AE - Abu Dhabi
Afganistán - AF - Kabul
Antigua y Barbuda - AG - Saint John
Anguila - AI - El Valle
Albania - AL - Tirana
Armenia - AM - Ereván
Angola - AO - Luanda
Región del Tratado Antártico - AQ - Región del Tratado Antártico
Argentina - AR - Buenos Aires
Samoa Americana - AS - Pago Pago
Austria - AT - Viena
Australia - AU - Canberra
Aruba - AW - Oranjestad
Åland - AX - Mariehamn
Azerbaiyán - AZ - Bakú
Bosnia y Herzegovina - BA - Sarajevo
Barbados - BB - Bridgetown
Bangladés - BD - Daca
Bélgica - BE - Bruselas
Burkina Faso - BF - Uagadugú
Bulgaria - BG - Sofía
Baréin - BH - Manama
Burundi - BI - Guitega
Benín - BJ - Porto Novo
San Bartolomé - BL - Gustavia
Bermudas - BM - Hamilton
Brunéi - BN - Bandar Seri Begawan
Bolivia - BO - Sucre
Caribe neerlandés - BQ - Kralendijk
Brasil - BR - Brasilia
Bahamas - BS - Nasáu
Bután - BT - Timbu
Isla Bouvet - BV - Isla Bouvet
Botsuana - BW - Gaborone
Bielorrusia - BY - Minsk
Belice - BZ - Belmopán
Canadá - CA - Ottawa
islas Cocos - CC - West Island
República Democrática del Congo - CD - Kinsasa
República Centroafricana - CF - Bangui
República del Congo - CG - Brazzaville
Suiza - CH - Berna
Costa de Marfil - CI - Yamusukro
Islas Cook - CK - Avarua
Chile - CL - Santiago de Chile
Camerún - CM - Yaundé
República Popular China - CN - Pekín
Colombia - CO - Bogotá
Costa Rica - CR - San José
Cuba - CU - La Habana
Cabo Verde - CV - Praia
Curazao - CW - Willemstad
Isla de Navidad - CX - Flying Fish Cove
Chipre - CY - Nicosia
República Checa - CZ - Praga
Alemania - DE - Berlín
Yibuti - DJ - Yibuti
Dinamarca - DK - Copenhague
Dominica - DM - Roseau
República Dominicana - DO - Santo Domingo
Argelia - DZ - Argel
Ecuador - EC - Quito
Estonia - EE - Tallin
Egipto - EG - El Cairo
Sahara Occidental - EH - Sahara Occidental
Eritrea - ER - Asmara
España - ES - Madrid
Etiopía - ET - Adís Abeba
Finlandia - FI - Helsinki
Fiyi - FJ - Suva
Islas Malvinas - FK - Puerto Argentino
Estados Federados de Micronesia - FM - Palikir
Islas Feroe - FO - Tórshavn
Francia - FR - París
Gabón - GA - Libreville
Reino Unido - GB - Londres
Inglaterra - GB-ENG - Londres
Irlanda del Norte - GB-NIR - Belfast
Escocia - GB-SCT - Edimburgo
Gales - GB-WLS - Cardiff
Granada - GD - Saint George
Georgia - GE - Tiflis
Guayana Francesa - GF - Cayena
Guernsey - GG - Saint Peter Port
Ghana - GH - Acra
Gibraltar - GI - Gibraltar
Groenlandia - GL - Nuuk
Gambia - GM - Banjul
Guinea - GN - Conakri
Guadalupe - GP - Basse-Terre
Guinea Ecuatorial - GQ - Malabo
Grecia - GR - Atenas
Islas Georgias del Sur y Sandwich del Sur - GS - King Edward Point
Guatemala - GT - Ciudad de Guatemala
Guam - GU - Agaña
Guinea-Bisáu - GW - Bisáu
Guyana - GY - Georgetown
Hong Kong - HK - Hong Kong
Islas Heard y McDonald - HM - Islas Heard y McDonald
Honduras - HN - Tegucigalpa
Croacia - HR - Zagreb
Haití - HT - Puerto Príncipe
Hungría - HU - Budapest
Indonesia - ID - Yakarta
Irlanda - IE - Dublín
Israel - IL - Jerusalén
Isla de Man - IM - Douglas
India - IN - Nueva Delhi
Territorio Británico del Océano Índico - IO - Diego García
Irak - IQ - Bagdad
Irán - IR - Teherán
Islandia - IS - Reikiavik
Italia - IT - Roma
Jersey - JE - Saint Helier
Jamaica - JM - Kingston
Jordania - JO - Amán
Japón - JP - Tokio
Kenia - KE - Nairobi
Kirguistán - KG - Biskek
Camboya - KH - Nom Pen
Kiribati - KI - Tarawa Sur
Comoras - KM - Moroni
San Cristóbal y Nieves - KN - Basseterre
Corea del Norte - KP - Pionyang
Corea del Sur - KR - Seúl
Kuwait - KW - Ciudad de Kuwait
Islas Caimán - KY - George Town
Kazajistán - KZ - Astana
Laos - LA - Vientián
Líbano - LB - Beirut
Santa Lucía - LC - Castries
Liechtenstein - LI - Vaduz
Sri Lanka - LK - Sri Jayawardenapura Kotte
Liberia - LR - Monrovia
Lesoto - LS - Maseru
Lituania - LT - Vilna
Luxemburgo - LU - Luxemburgo
Letonia - LV - Riga
Libia - LY - Trípoli
Marruecos - MA - Rabat
Mónaco - MC - comuna de Mónaco
Moldavia - MD - Chisináu
Montenegro - ME - Podgorica
San Martín - MF - Marigot
Madagascar - MG - Antananarivo
Islas Marshall - MH - Majuro
Macedonia del Norte - MK - Skopie
Mali - ML - Bamako
Birmania - MM - Naipyidó
Mongolia - MN - Ulán Bator
Macao - MO - Macao
Islas Marianas del Norte - MP - Q49755159
Martinica - MQ - Fort-de-France
Mauritania - MR - Nuakchot
Montserrat - MS - Brades
Malta - MT - La Valeta
Mauricio - MU - Port Louis
Maldivas - MV - Malé
Malaui - MW - Lilongüe
México - MX - Ciudad de México
Malasia - MY - Kuala Lumpur
Mozambique - MZ - Maputo
Namibia - NA - Windhoek
Nueva Caledonia - NC - Numea
Níger - NE - Niamey
Isla Norfolk - NF - Kingston
Nigeria - NG - Abuya
Nicaragua - NI - Managua
Reino de los Países Bajos - NL - Ámsterdam
Noruega - NO - Oslo
Nepal - NP - Katmandú
Nauru - NR - Yaren
Niue - NU - Alofi
Nueva Zelanda - NZ - Wellington
Omán - OM - Mascate
Panamá - PA - Ciudad de Panamá
Perú - PE - Lima
Polinesia Francesa - PF - Papeete
Papúa Nueva Guinea - PG - Puerto Moresby
Filipinas - PH - Manila
Pakistán - PK - Islamabad
Polonia - PL - Varsovia
San Pedro y Miquelón - PM - San Pedro
Islas Pitcairn - PN - Adamstown
Puerto Rico - PR - San Juan
Estado de Palestina - PS - Ramala
Portugal - PT - Lisboa
Palaos - PW - Ngerulmud
Paraguay - PY - Asunción
Catar - QA - Doha
Reunión - RE - Saint-Denis
Rumania - RO - Bucarest
Serbia - RS - Belgrado
Rusia - RU - Moscú
Ruanda - RW - Kigali
Arabia Saudí - SA - Riad
Islas Salomón - SB - Honiara
Seychelles - SC - Victoria
Sudán - SD - Jartum
Suecia - SE - Estocolmo
Singapur - SG - Singapur
Santa Elena, Ascensión y Tristán de Acuña - SH - Jamestown
Eslovenia - SI - Liubliana
Svalbard y Jan Mayen - SJ - Longyearbyen
Eslovaquia - SK - Bratislava
Sierra Leona - SL - Freetown
San Marino - SM - San Marino
Senegal - SN - Dakar
Somalia - SO - Mogadiscio
Surinam - SR - Paramaribo
Sudán del Sur - SS - Yuba
Santo Tomé y Príncipe - ST - Santo Tomé
El Salvador - SV - San Salvador
San Martín - SX - Philipsburg
Siria - SY - Damasco
Esuatini - SZ - Lobamba
Islas Turcas y Caicos - TC - Cockburn Town
Chad - TD - Yamena
Tierras Australes y Antárticas Francesas - TF - Port-aux-Français
Togo - TG - Lomé
Tailandia - TH - Bangkok
Tayikistán - TJ - Dusambé
Tokelau - TK - Fakaofo
Timor Oriental - TL - Dili
Turkmenistán - TM - Asjabad
Túnez - TN - Túnez
Tonga - TO - Nukualofa
Turquía - TR - Ankara
Trinidad y Tobago - TT - Puerto España
Tuvalu - TV - Funafuti
República de China - TW - Taipéi
Tanzania - TZ - Dodoma
Ucrania - UA - Kiev
Uganda - UG - Kampala
Islas ultramarinas de Estados Unidos - UM - Islas ultramarinas de Estados Unidos
Estados Unidos - US - Washington D. C.
Uruguay - UY - Montevideo
Uzbekistán - UZ - Taskent
Ciudad del Vaticano - VA - Ciudad del Vaticano
San Vicente y las Granadinas - VC - Kingstown
Venezuela - VE - Caracas
Islas Vírgenes Británicas - VG - Road Town
Islas Vírgenes de los Estados Unidos - VI - Charlotte Amalie
Vietnam - VN - Hanói
Vanuatu - VU - Port Vila
Wallis y Futuna - WF - Mata-Utu
Samoa - WS - Apia
Kosovo - XK - Pristina
Yemen - YE - Adén
Mayotte - YT - Dzaoudzi
Sudáfrica - ZA - Bloemfontein
Zambia - ZM - Lusaka
Zimbabue - ZW - Harare
